Unità 9:

	- Clean the bathroom/fridge/oven/windows == Pulisci il bagno/frigorifero/forno/finestre
	- Clear the table == Sparecchia la tavola 
	- Do the dusting == Spolverare
	- Do the ironing == Stirare 
	- Do the vacumiing == Passare l'aspirapolvere
	- Do the washing == Lavare le stoviglie
	- Do the washing up == Lavare i panni
	- Feed the pets == Dai da mangiare agli animali 
	- Hang the washing out == Stendi i panni
	- Lay the table == Apparecchia la tavola 
	- Load the dishwasher == Carica la lavatrice 
	- Make dinner == Prepara cena
	- Make the bed == Fare il letto
	- Put the bins out  == Porta fuori l'immondizia 
	- Sort the recycling == Riciclare
	- Tidy up == Sistemare
	- Unload the dishwasher == Scarica la lavatrice 
	- Walk the dog == Porta a spasso il cane
	- Make a cake == Fare una torta 
	- Make a decision == Prendi una decisione 
	- Make a list == Fare una lista 
	- Make a noise == Fare un rumore 
	- Make a phone call == Fare una chiamata 
	- Make a sandwich == Fare un panino 
	- Make breakfast/lunch/dinner == Prepara colazione/pranzo/cena
	- Make money == Fare soldi
	- Make progress == Fare progressi
	- Make some tea/coffee == Prepara del the/caffè
	- Make the bed == Fare il letto
	- Do a job == Fare un lavoro
	- Do a project == Fare un progetto
	- Do a test == Fare un test
	- Do excersise == Fare un esercizio
	- Do homework == Fare i compiti 
	- Do research == Fare una ricerca
	- Do the cleaning == Pulire 
	- Do the shopping == Fare shopping
	- Do well/badly == Andare bene/male
	- Do your best == Fare il tuo meglio
	- Find out == scoprire
	- Get Back == tornare indietro
	- Go out == andare fuori
	- Sit up == tirarsi su
	- stay away == stare lontano
	- Stay in == stare dentro
	- Stay up == stare alzato
	- Take off == togliersi
	- Turn on == accendere
	- Bin == bidone
	- Brush == Spazzola
	- Bucket == secchio
	- Cloth == stoffa
	- Dishwasher == Lavastoviglie
	- Duster == Spolverino
	- Dustpan == paletta 
	- Iron == ferro da stiro
	- Ironing board == asse da stiro
	- Laundry basket == Cestino della lavanderia 
	- Mop == mocio
	- Rubber gloves == guanti di gomma 
	- Vacuum cleaner == Aspirapolvere 
	- Washing line == filo della biancheria 
	- Washing Machine == Lavatrice

Unità 10:

	- Cartoon == cartone animato
	- Collage == collage
	- Drawing == disegno
	- Painting == dipinto
	- Photograph == Fotografia 
	- Print == stampa
	- Sculpture == scultura 
	- Sketch == Schizzo/disegno veloce
	- Graffiti == Graffiti
	- Architecture == architettura
	- Dance == danza 
	- Drama == Teatro
	- Graphic design == progetto grafico
	- Knitting == lavoro a maglia
	- literature == letteratura 
	- music == musica 
	- Poetry == poesia 
	- Pottery == modellamento
	- Singing == canto 
	- Song-writing == scrittura di canzoni
	- Textiles == arte tessile 
	- Amazing ==  bellissimo
	- Awful == orrendo
	- Beautiful == meraviglioso
	- Breathtaking == mozzafiato
	- Brilliant == brillante 
	- Impressive == impressionante 
	- Inspiring == di ispirazione
	- Ridicoulus == ridicolo
	- Scary == spaventoso
	- Shocking == scioccante 
	- Ugly == brutto
	- Weird == strano
	- Camera == macchina fotografica 
	- Canvass == tela
	- Clay == argilla 
	- Easel == Cavalletto
	- Glue == colla 
	- Ink == inchiostro
	- Knitting needles == ferri da maglia 
	- Music stand == Leggio 
	- Oil paint == pittura ad olio 
	- Paint brush == pennello
	- Pencils == pastelli
	- Potter's wheel == tornio da ceramicaio
	- Sewing machine == macchina da cucire 
	- Sketch book == Libro degli schizzi
	- Spray paint = vernice spray 